

///////////////////////////////////////////////////////////////////    Ключевые слова    ////////////////////////////////////////////////////////////////////////


ADD                         -  Добавляет столбец в существующую таблицу
ADD CONSTRAINT              -  Добавляет ограничение после того, как таблица уже создана
ALTER                       -  Добавляет, удаляет или изменяет столбцы в таблице, а также изменяет данные тип столбца в таблице
ALTER COLUMN                -  Изменяет тип данных столбца в таблице
ALTER TABLE                 -  Добавляет, удаляет или изменяет столбцы в таблице
ALL	                        -  Возвращает true, если все значения подзапроса соответствуют состояние
AND	                        -  Включает только строки, где оба условия истинны
ANY	                        -  Возвращает true, если какое                    - либо из значений подзапроса соответствует состоянию
AS                          -  Переименовывает столбец или таблицу с помощью псевдонима
ASC                         -  Сортировка результирующего набора в порядке возрастания
BACKUP DATABASE             -  Создает резервную копию существующей базы данных
BETWEEN	                    -  Выбор значений в заданном диапазоне
CASE                        -  Создает различные выходные данные в зависимости от условий
CHECK                       -  Ограничение, ограничивающее значение, которое может быть помещено в колонка
COLUMN                      -  Изменяет тип данных столбца или удаляет столбец в таблице
CONSTRAINT                  -  Добавляет или удаляет ограничение
CREATE                      -  Создает базу данных, индекс, представление, таблицу или процедуру
CREATE DATABASE             -  Создает новую базу данных SQL
CREATE INDEX                -  Создает индекс в таблице (позволяет дублировать значения)
CREATE OR REPLACE VIEW      -  Обновление представления
CREATE TABLE                -  Создает новую таблицу в базе данных
CREATE PROCEDURE            -  Создает хранимую процедуру
CREATE UNIQUE INDEX         -  Создает уникальный индекс в таблице (без повторяющихся значений)
CREATE VIEW                 -  Создает представление на основе результирующего набора инструкции SELECT
DATABASE                    -  Создает или удаляет базу данных SQL
DEFAULT                     -  Ограничение, предоставляющее значение по умолчанию для столбца
DELETE                      -  Удаляет строки из таблицы
DESC                        -  Сортировка результирующего набора в порядке убывания
DISTINCT                    -  Выбирает только отдельные (разные) значения
DROP                        -  Удаляет столбец, ограничение, базу данных, индекс, таблицу или представление
DROP COLUMN                 -  Удаляет столбец в таблице
DROP CONSTRAINT             -  Удаляет UNIQUE, PRIMARY KEY, FOREIGN KEY, или ограничение CHECK
DROP DATABASE               -  Удаляет существующую базу данных SQL
DROP DEFAULT                -  Удаляет ограничение по умолчанию
DROP INDEX                  -  Удаление индекса в таблице
DROP TABLE                  -  Удаляет существующую таблицу в базе данных
DROP VIEW                   -  Удаление представления
EXEC                        -  Выполняет хранимую процедуру
EXISTS                      -  Тесты на наличие любой записи в подзапросе
FOREIGN KEY                 -  Ограничение, которое является ключом, используемым для связывания двух таблиц вместе
FROM                        -  Указывает, из какой таблицы следует выбрать или удалить данные
FULL OUTER JOIN             -  Возвращает все строки при наличии совпадения в левой или правой таблице
GROUP BY                    -  Группирует результирующий набор (используется с агрегатными функциями: COUNT, MAX, MIN, SUM, AVG)
HAVING                      -  Используется вместо WHERE с агрегатными функциями
IN                          -  Позволяет указать несколько значений в предложении WHERE
INDEX                       -  Создает или удаляет индекс в таблице
INNER JOIN                  -  Возвращает строки, имеющие совпадающие значения в обеих таблицах
INSERT INTO                 -  Вставка новых строк в таблицу
INSERT INTO SELECT          -  Копирует данные из одной таблицы в другую
IS NULL                     -  Тесты для пустых значений
IS NOT NULL                 -  Тесты для непустых значений
JOIN                        -  Для объединения таблиц
LEFT JOIN                   -  Возвращает все строки из левой таблицы и соответствующие строки из правой таблицы
LIKE                        -  Поиск указанного шаблона в столбце
LIMIT                       -  Задает количество записей, возвращаемых в результирующем наборе
NOT                         -  Включает только строки, в которых условие не является истинным
NOT NULL                    -  Ограничение, которое заставляет столбец не принимать нулевые значения
OR                          -  Включает строки, в которых выполняется любое из условий
ORDER BY                    -  Сортировка результирующего набора в порядке возрастания или убывания
OUTER JOIN                  -  Возвращает все строки при наличии совпадения в левой или правой таблице
PRIMARY KEY                 -  Ограничение, которое однозначно идентифицирует каждую запись в таблице базы данных
PROCEDURE                   -  Хранимая процедура
RIGHT JOIN                  -  Возвращает все строки из правой таблицы и соответствующие строки из левой таблицы
ROWNUM                      -  Задает количество записей, возвращаемых в результирующем наборе
SELECT                      -  Выбор данных из базы данных
SELECT DISTINCT             -  Выбирает только отдельные (разные) значения
SELECT INTO                 -  Копирует данные из одной таблицы в новую таблицу
SELECT TOP                  -  Задает количество записей, возвращаемых в результирующем наборе
SET                         -  Указывает, какие столбцы и значения должны быть обновлены в таблице
TABLE                       -  Создает таблицу, добавляет, удаляет или изменяет столбцы в таблице, а также удаляет таблицу или данные внутри таблицы
TOP                         -  Задает количество записей, возвращаемых в результирующем наборе
TRUNCATE TABLE              -  Удаляет данные внутри таблицы, но не саму таблицу
UNION                       -  Объединяет результирующий набор из двух или более операторов SELECT (только отдельные значения)
UNION ALL                   -  Объединяет результирующий набор из двух или более операторов SELECT (позволяет дублировать значения)
UNIQUE                      -  Ограничение, обеспечивающее уникальность всех значений в столбце
UPDATE                      -  Обновление существующих строк в таблице
VALUES                      -  Задает значения инструкции INSERT INTO
VIEW                        -  Создает, обновляет или удаляет представление
WHERE                       -  Фильтрует результирующий набор для включения только тех записей, которые удовлетворяют заданному условию


/////////////////////////////////////////////////////////////////////  MySQL Расширенные функции  ///////////////////////////////////////////////////////


ASCII                       -  Возвращает значение ASCII для конкретного символа
CHAR_LENGTH                 -  Возвращает длину строки (в символах)
CHARACTER_LENGTH            -  Возвращает длину строки (в символах)
CONCAT                      -  Добавляет два или более выражений вместе
CONCAT_WS                   -  Добавляет два или более выражений вместе с разделителем
FIELD                       -  Возвращает индексную позицию значения в списке значений
FIND_IN_SET                 -  Возвращает положение строки в списке строк
FORMAT                      -  Форматирует число в такой формат, как "#,###,###.##", округленный до заданного количества знаков после запятой
INSERT                      -  Вставляет строку в строку в указанной позиции и для определенного количества символов
INSTR                       -  Возвращает позицию первого вхождения строки в другую строку
LCASE                       -  Преобразует строку в нижний регистр
LEFT                        -  Извлекает ряд символов из строки (начиная слева)
LENGTH                      -  Возвращает длину строки (в байтах)
LOCATE                      -  Возвращает позицию первого вхождения подстроки в строку
LOWER                       -  Преобразует строку в нижний регистр
LPAD                        -  Слева-накладывает строку с другой строкой, до определенной длины
LTRIM                       -  Удаляет начальные пробелы из строки
MID                         -  Извлекает подстроку из строки (начиная с любой позиции)
POSITION                    -  Возвращает позицию первого вхождения подстроки в строку
REPEAT                      -  Повторяет строку столько раз, сколько указано
REPLACE                     -  Заменяет все вхождения подстроки в строке на новую подстроку
REVERSE                     -  Переворачивает строку и возвращает результат
RIGHT                       -  Извлекает ряд символов из строки (начиная справа)
RPAD                        -  Правая накладывает строку с другой строкой, до определенной длины
RTRIM                       -  Удаляет конечные пробелы из строки
SPACE                       -  Возвращает строку с указанным количеством пробелов
STRCMP                      -  Сравнивает две строки
SUBSTR                      -  Извлекает подстроку из строки (начиная с любой позиции)
SUBSTRING                   -  Извлекает подстроку из строки (начиная с любой позиции)
SUBSTRING_INDEX             -  Возвращает подстроку строки до появления указанного числа разделителей
TRIM                        -  Удаляет начальные и конечные пробелы из строки
UCASE                       -  Преобразует строку в верхний регистр
UPPER                       -  Преобразует строку в верхний регистр

ABS                         -  Возвращает абсолютное значение числа
ACOS                        -  Возвращает арккосинус числа
ASIN                        -  Возвращает арксин числа
ATAN                        -  Возвращает арктангенс одного или двух чисел
ATAN2                       -  Возвращает тангенс дуги двух чисел
AVG                         -  Возвращает среднее значение выражения
CEIL                        -  Возвращает наименьшее целочисленное значение, равное >= числу
CEILING                     -  Возвращает наименьшее целочисленное значение, равное >= числу
COS                         -  Возвращает косинус числа
COT                         -  Возвращает котангенс числа
COUNT                       -  Возвращает количество записей, возвращенных запросом select
DEGREES                     -  Преобразует значение в радианах в градусы
DIV                         -  Используется для целочисленного деления
EXP                         -  Возвращает значение e, возведенное в степень заданного числа
FLOOR                       -  Возвращает наибольшее целочисленное значение, равное <= числу
GREATEST                    -  Возвращает наибольшее значение списка аргументов
LEAST                       -  Возвращает наименьшее значение из списка аргументов
LN                          -  Возвращает натуральный логарифм числа
LOG                         -  Возвращает натуральный логарифм числа или логарифм числа к заданному основанию
LOG10                       -  Возвращает натуральный логарифм числа к основанию 10
LOG2                        -  Возвращает натуральный логарифм числа в основание 2
MAX                         -  Возвращает максимальное значение в наборе значений
MIN                         -  Возвращает минимальное значение в наборе значений
MOD                         -  Возвращает остаток числа, разделенный на другое число
PI                          -  Возвращает значение PI
POW                         -  Возвращает значение числа, возведенное в степень другого числа
POWER                       -  Возвращает значение числа, возведенное в степень другого числа
RADIANS                     -  Преобразует значение градуса в радианы
RAND                        -  Возвращает случайное число
ROUND                       -  Округляет число до заданного количества знаков после запятой
SIGN                        -  Возвращает знак числа
SIN                         -  Возвращает синус числа
SQRT                        -  Возвращает квадратный корень из числа
SUM                         -  Вычисляет сумму набора значений
TAN                         -  Возвращает тангенс числа
TRUNCATE                    -  Усечение числа до указанного количества знаков после запятой

ADDDATE                     -  Добавляет интервал времени/даты к дате, а затем возвращает дату
ADDTIME                     -  Добавляет временной интервал к времени/дате времени, а затем возвращает время/дату времени
CURDATE                     -  Возвращает текущую дату
CURRENT_DATE                -  Возвращает текущую дату
CURRENT_TIME                -  Возвращает текущее время
CURRENT_TIMESTAMP           -  Возвращает текущую дату и время
CURTIME                     -  Возвращает текущее время
DATE                        -  Извлекает дату из datetime выражение
DATEDIFF                    -  Возвращает количество дней между двумя значениями даты
DATE_ADD                    -  Добавляет интервал времени/даты к дате, а затем возвращает дату
DATE_FORMAT                 -  Форматирование даты
DATE_SUB                    -  Вычитает интервал времени/даты из даты, а затем возвращает дату
DAY                         -  Возвращает день месяца для заданной даты
DAYNAME                     -  Возвращает название дня недели для заданной даты
DAYOFMONTH                  -  Возвращает день месяца для заданной даты
DAYOFWEEK                   -  Возвращает индекс дня недели для заданной даты
DAYOFYEAR                   -  Возвращает день года для заданной даты
EXTRACT                     -  Извлекает часть из заданной даты
FROM_DAYS                   -  Возвращает дату из числового значения даты
HOUR                        -  Возвращает часовую часть для заданной даты
LAST_DAY                    -  Извлекает последний день месяца для заданной даты
LOCALTIME                   -  Возвращает текущую дату и время
LOCALTIMESTAMP              -  Возвращает текущую дату и время
MAKEDATE                    -  Создает и возвращает дату на основе значения года и количества дней
MAKETIME                    -  Создает и возвращает время, основанное на часе, минуте и втором значении
MICROSECOND                 -  Возвращает микросекундную часть время/даты-время
MINUTE                      -  Возвращает минутную часть время/даты-время
MONTH                       -  Возвращает часть месяца для заданной даты
MONTHNAME                   -  Возвращает название месяца для заданной даты
NOW                         -  Возвращает текущую дату и время
PERIOD_ADD                  -  Добавляет к периоду заданное количество месяцев
PERIOD_DIFF                 -  Возвращает разницу между двумя периодами
QUARTER                     -  Возвращает квартал года для заданного значения даты
SECOND                      -  Возвращает секундную часть времени/даты-время
SEC_TO_TIME                 -  Возвращает значение времени, основанное на указанных секундах
STR_TO_DATE                 -  Возвращает дату на основе строки и формата
SUBDATE                     -  Вычитает интервал времени/даты из даты, а затем возвращает дату
SUBTIME                     -  Уменьшает интервал времени из DateTime и возвращает время/дата-время
SYSDATE                     -  Возвращает текущую дату и время
TIME                        -  Извлекает время от данный момент времени
TIME_FORMAT                 -  Форматирует время по заданному формату
TIME_TO_SEC                 -  Преобразует значение времени в секунды
TIMEDIFF                    -  Возвращает разницу между двумя выражениями время/дата-время
TIMESTAMP                   -  Возвращает значение datetime значение даты или типа datetime
TO_DAYS                     -  Возвращает количество дней между датой и датой "0000-00-00"
WEEK                        -  Возвращает номер недели для заданной даты
WEEKDAY                     -  Возвращает номер дня недели для заданной даты
WEEKOFYEAR                  -  Возвращает номер недели для заданной даты
YEAR                        -  Возвращает часть года для заданной даты
YEARWEEK                    -  Возвращает номер года и недели для заданной даты

BIN                         -  Возвращает двоичное представление числа
BINARY                      -  Преобразует значение в двоичную строку
CASE                        -  Проходит через условия и возвращает значение при выполнении первого условия
CAST                        -  Преобразует значение (любого типа) в указанный тип данных
COALESCE                    -  Возвращает первое ненулевое значение в списке
CONNECTION_ID               -  Возвращает уникальный идентификатор соединения для текущего соединения
CONV                        -  Преобразует число из одной числовой базовой системы в другую
CONVERT                     -  Преобразует значение в указанный тип данных или набор символов
CURRENT_USER                -  Возвращает имя пользователя и имя хоста для учетной записи MySQL, которую сервер использовал для аутентификации текущего клиента
DATABASE                    -  Возвращает имя текущей базы данных
IF                          -  Возвращает значение, если условие истинно, или другое значение, если условие FALSE
IFNULL                      -  Возвращает указанное значение, если выражение равно NULL, в противном случае возвращает выражение
ISNULL                      -  Возвращает 1 или 0 в зависимости от того, является ли выражение NULL
LAST_INSERT_ID              -  Возвращает идентификатор AUTO_INCREMENT последней строки, которая была вставлена или обновлена в таблице
NULLIF                      -  Сравнивает два выражения и возвращает NULL, если они равны. В противном случае возвращается первое выражение
SESSION_USER                -  Возвращает текущее имя пользователя и хоста MySQL
SYSTEM_USER                 -  Возвращает текущее имя пользователя и хоста MySQL
USER                        -  Возвращает текущее имя пользователя и хоста MySQL
VERSION                     -  Возвращает текущую версию базы данных MySQL


//////////////////////////////////////////////////////////////   SQL Server   ////////////////////////////////////////////////////////////////////


ASCII                       -  Возвращает значение ASCII для конкретного символа
CHAR                        -  Возвращает символ, основанный на коде ASCII
CHARINDEX                   -  Возвращает положение подстроки в строке
CONCAT                      -  Добавляет две или более строк вместе
Concat with +               -  Добавляет две или более строк вместе
CONCAT_WS                   -  Добавляет две или более строк вместе с разделителем
DATALENGTH                  -  Возвращает количество байтов, используемых для представления выражения
DIFFERENCE                  -  Сравнивает два значения SOUNDEX и возвращает целое значение
FORMAT                      -  Форматирует значение с указанным форматом
LEFT                        -  Извлекает ряд символов из строки (начиная слева)
LEN                         -  Возвращает длину строки
LOWER                       -  Преобразует строку в нижний регистр
LTRIM                       -  Удаляет начальные пробелы из строки
NCHAR                       -  Возвращает символ Unicode, основанный на числовом коде
PATINDEX                    -  Возвращает положение шаблона в строке
QUOTENAME                   -  Возвращает строку Unicode с добавленными разделителями, чтобы сделать строку допустимым идентификатором с разделителями SQL Server
REPLACE                     -  Заменяет все вхождения подстроки в строке на новую подстроку
REPLICATE                   -  Повторяет строку заданное количество раз
REVERSE                     -  Переворачивает строку и возвращает результат
RIGHT                       -  Извлекает ряд символов из строки (начиная справа)
RTRIM                       -  Удаляет конечные пробелы из строки
SOUNDEX                     -  Возвращает четырехсимвольный код для оценки сходства двух строк
SPACE                       -  Возвращает строку с указанным количеством пробелов
STR                         -  Возвращает число в виде строки
STUFF                       -  Удаляет часть строки, а затем вставляет другую часть в строку, начиная с указанной позиции
SUBSTRING                   -  Извлекает некоторые символы из строки
TRANSLATE                   -  Возвращает строку из первого аргумента после того, как символы, указанные во втором аргументе, будут переведены в символы, указанные в третьем аргументе.
TRIM                        -  Удаляет начальные и конечные пробелы (или другие указанные символы) из строки
UNICODE                     -  Возвращает значение Unicode для первого символа входного выражения
UPPER                       -  Преобразует строку в верхний регистр

ABS                         -  Возвращает абсолютное значение числа
ACOS                        -  Возвращает арккосинус числа
ASIN                        -  Возвращает арксин числа
ATAN                        -  Возвращает арктангенс числа
ATN2                        -  Возвращает тангенс дуги двух чисел
AVG                         -  Возвращает среднее значение выражения
CEILING                     -  Возвращает наименьшее целочисленное значение, равное >= числу
COUNT                       -  Возвращает количество записей, возвращенных запросом select
COS                         -  Возвращает косинус числа
COT                         -  Возвращает котангенс числа
DEGREES                     -  Преобразует значение в радианах в градусы
EXP                         -  Возвращает значение e, возведенное в степень заданного числа
FLOOR                       -  Возвращает наибольшее целочисленное значение, равное <= числу
LOG                         -  Возвращает натуральный логарифм числа или логарифм числа к заданному основанию
LOG10                       -  Возвращает натуральный логарифм числа к основанию 10
MAX                         -  Возвращает максимальное значение в наборе значений
MIN                         -  Возвращает минимальное значение в наборе значений
PI                          -  Возвращает значение PI
POWER                       -  Возвращает значение числа, возведенное в степень другого числа
RADIANS                     -  Преобразует значение градуса в радианы
RAND                        -  Возвращает случайное число
ROUND                       -  Округляет число до заданного количества знаков после запятой
SIGN                        -  Возвращает знак числа
SIN                         -  Возвращает синус числа
SQRT                        -  Возвращает квадратный корень из числа
SQUARE                      -  Возвращает квадрат числа
SUM                         -  Вычисляет сумму набора значений
TAN                         -  Возвращает тангенс числа

CURRENT_TIMESTAMP           -  Возвращает текущую дату и время
DATEADD                     -  Добавляет интервал времени/даты к дате, а затем возвращает дату
DATEDIFF                    -  Возвращает разницу между двумя датами
DATEFROMPARTS               -  Возвращает дату из указанных частей (значения года, месяца и дня)
DATENAME                    -  Возвращает указанную часть даты (в виде строки)
DATEPART                    -  Возвращает заданную часть даты (в виде целого числа)
DAY                         -  Возвращает день месяца для указанной даты
GETDATE                     -  Возвращает текущую системную дату и время базы данных
GETUTCDATE                  -  Возвращает текущую дату и время UTC системы баз данных
ISDATE                      -  Проверяет выражение и возвращает 1, если это допустимая дата, в противном случае 0
MONTH                       -  Возвращает часть месяца для указанной даты (число от 1 до 12)
SYSDATETIME                 -  Возвращает дату и время работы SQL Server
YEAR                        -  Возвращает часть года для указанной даты

CAST                        -  Преобразует значение (любого типа) в указанный тип данных
COALESCE                    -  Возвращает первое ненулевое значение в списке
CONVERT                     -  Преобразует значение (любого типа) в указанный тип данных
CURRENT_USER                -  Возвращает имя текущего пользователя в базе данных SQL Server
IIF                         -  Возвращает значение, если условие TRUE, или другое значение, если условие FALSE
ISNULL                      -  Возвращает указанное значение, если выражение равно NULL, в противном случае возвращает выражение
ISNUMERIC                   -  Проверяет, является ли выражение числовым
NULLIF                      -  Возвращает NULL, если два выражения равны
SESSION_USER                -  Возвращает имя текущего пользователя в базе данных SQL Server
SESSIONPROPERTY             -  Возвращает настройки сеанса для указанного параметра
SYSTEM_USER                 -  Возвращает имя входа для текущего пользователя
USER_NAME                   -  Возвращает имя пользователя базы данных на основе указанного id
